###########################################
#..............#..................#....D..#
#...D..........#..............s...#.......#
#..............#......%...........#.......#
#...........s..#..........................#
########.......#..........................#
#.........................#####....s......#
#.........................#..........######
#...................%.....#...............#
#P........................#.%........#..D.#
###########################################
